-------------1
-D1---2-------
--O--O--------
----------2---
---------O----
-1--O---------
--------2-----
2------O----1-
--------------
--------------
--O--O--O--O--
--A--A--A--A--
2------------2