O---------111
1------------
-----------A-
-------1O----
-A-----------
---O---------
----1-------A
----------O--
-A----------1
----O--------
-------------
-------------
11---------1D