------------O-1
------------O--
------O-AAA-O--
------O--A--O--
11----O-----O--
---------------
11-------------
------O---OOO12
-----2O--------
----OOO--------
------------111
---------------
----O-----OOOOO
----O---------D
---2O----------