-------------1
--1-1-1-1-----
--OOOOOOO-----
--------------
-----------O1-
------OO---O--
1-O--------O1-
--O-----------
1-O--OOOO-----
-1O---AA---O1-
--O---AA---OD1
-1O---OO---O1-
------11------
------11-----1