-3O3-----------
--O-----------3
--O--OOOOOOOOOO
--O-----------3
--O------------
--O--O-A-O--O--
--O--OAAAO--O--
--O--OOOOO--O--
--O--O-D-O--O--
--O--O---O--O--
------------O--
3-----------O--
OOOOOOOOOO--O--
3-----------O--
-----------3O3-