-1O--O--------------
--O---O------------1
--O----O-----OO-OOOO
--------OA--OO------
---------O1OO------1
OOOOO----1OO-----OOO
---------OO--------1
--------O-----------
OOOA--OOO---OOOOOOOO
--1O---O------------
---O---O------------
---O-------OO---OO--
------------1O-O1---
---OOO---OOOOO-OOOOO
----1OO-OO2---------
A----OO-OO---------A
OOOOOOO-OOOOOOOOOOOO
1D-----------------1
OO---1-1-1--------OO
1------------------1