OO------DOOO
OO-OOOOOOOO-
OO--1---1---
OOOOOOOOOOO-
----1---OOO-
1OOOOOO----1
-OO-OOOOOOOO
--1-OOOOOOO-
OOO----1----
OOOOOOOOOOO-
11AAAA------